1111111111111111111111111111
1.BB.........B......1......1
1.BP..........B........B...1
1......BB......B.........111
11...........B......B......1
1......B................1..1
1....................1.....1
1111111111111111111111111111
